##################################################
#                                                #
#                                                #
#                                                #
#                        M                       #
#                                                #
#                                                #
#                                                #
#            H                                   #
#                                                #
#                                                #
#                                                #
#                                                #
##################################################

